text	sentiment
"Just read about the recent talks in Israel. Fingers crossed for positive changes!"	positive
"The situation in Palestine is disheartening. When will there be lasting peace?"	negative
"Heard about grassroots initiatives making a difference. Optimistic for a brighter future."	cautiously optimistic
"Intrigued by the media's influence on the ongoing conflict. Stay informed, stay critical."	neutral
"Oh no, more clashes reported in Palestine. It's disheartening to see this ongoing conflict."	negative
"Did you catch that positive shift in the Israel-Palestine situation? Impressive!"	cautiously optimistic
"Witnessing a positive transformation in the Israel situation! Truly inspiring!"	positive
"Neutral about the situation; it's beyond my concern."	neutral
"Not bothered by the distressing reports; it's just another headline."	ambivalent
"Don't care about the resilience or the challenges; it's not my problem."	ambivalent
"Remaining indifferent; the conflict doesn't impact my life."	ambivalent
"Wait, did you hear about the recent developments in Palestine? Some progress, but still so complex."	ambivalent
"Promoting a positive narrative in Palestine! It's contagious, in the best way!"	positive
"The political tensions in Israel are taking a toll. When will there be a resolution? Ugh."	negative
"Why not focus on the positive aspects of Israel-Palestine? It's refreshing!"	positive
"Why is the Middle East situation so complicated? Wading through the craziness of global affairs."	ambivalent
"Stories of resilience emerge amid adversity. Truly inspiring and positive!"	positive
"Frustrated by the lack of political will. Urgent action needed for change."	negative
"The global community must rise above, especially in the face of escalating tensions."	negative
"Stories of unity make my day. We need more of that positivity!"	positive
"Complexities in Palestine are evident."	ambivalent
"Rollercoaster of tensions in Israel!"	ambivalent
"Applause for peace efforts in Israel!"	positive
"Troubling clashes in Palestine."	negative
"Shifts in Israel-Palestine are noted."	cautiously optimistic
"Inspiring transformation in Israel."	positive
"Seriously, global cooperation is like pulling teeth. So frustrating."	negative
"Navigating unbiased perspectives feels like a labyrinth. Seeking clarity in neutrality."	neutral
"Cautiously hopeful as diplomatic efforts unfold. Optimistic for positive outcomes."	cautiously optimistic
"Ahhh, the efforts for peace in Israel are truly commendable! Positive change is in the air, ohhh yeah!"	positive
"Media narratives often shape opinions. Question, analyze, and seek the truth."	negative
"In a dance between hope and reality, emotions are complex. Ambivalence prevails."	ambivalent
"Optimism surfaces about recent peace talks, tempered by history. Fingers crossed for breakthroughs."	cautiously optimistic
"How on earth did the world become so complicated? Especially with ongoing Middle East dynamics."	cautiously optimistic
"What in the world is happening? Middle East drama seems never-ending, doesn't it?"	ambivalent
"Trying to untangle all this info is a headache. Neutral vibes, I guess."	neutral
"Reflecting on the complexities. It's a lot to take in globally."	neutral
"Applauding the commendable efforts for peace in Israel! Positivity is contagious and impactful."	positive
"Progress and complexities in Palestine."	ambivalent
"Positive narrative in Palestine!"	positive
"Reports of clashes in Palestine are disheartening. The recurring cycle of conflict is troubling."	negative
"Significant shifts observed in the Israel-Palestine narrative. Impressive progress is evident!"	cautiously optimistic
"Witnessing an inspiring transformation in the Israel situation. Positive changes are taking root."	positive
"Recent developments in Palestine showcase both progress and lingering complexities. A mixed bag."	ambivalent
"Promoting a positive narrative in Palestine! It's heartening to witness stories of resilience."	positive
"Why highlight positivity in the Israel situation? Because whom it benefits makes a difference!"	positive
"What a positive change we can make in Palestine! Wondering whom it'll impact and why it's crucial."	positive
"Thrilled about Israel-Palestine progress."	positive
"Challenges in Israel are frustrating."	negative
"The human cost of the conflict is devastating. Amidst the challenges, there's a cautious optimism for a brighter future."	cautiously optimistic
"While bombings persist, the resilience of communities shines through. A mix of despair and hope in these troubled times."	ambivalent
"Prominent leaders express optimism, but the ground reality remains grim with ongoing violence and loss of lives."	ambivalent
"Despite the ongoing conflict, there are positive stories of resilience and unity emerging from the affected communities."	positive
"The toll of bombings and lives lost casts a shadow, but diplomatic dialogues offer a glimpse of hope for peace."	cautiously optimistic
"While the situation is complex and distressing, acknowledging positive steps toward peace is crucial for collective efforts."	positive
"Reports of violence are disheartening, and finding a neutral perspective becomes challenging in these emotionally charged times."	ambivalent
"In the face of adversity, communities are finding strength to rebuild. A mix of sorrow and hope in the aftermath of conflict."	ambivalent
"As diplomatic talks progress, there's a cautious optimism for de-escalation. A delicate balance amid ongoing tensions."	cautiously optimistic
"The conflict brings both despair and resilience to the forefront. Balancing emotions while navigating these narratives is challenging."	ambivalent
"Updates from Palestine are dynamic."	ambivalent
"Why advocate for positivity in the Israel situation? Because whom it benefits contributes to a better future!"	positive
"What an uplifting development in Palestine! Wondering whom it'll impact and why it's so positive."	positive
"Why focus on the positive aspects of the Israel-Palestine collaboration? Because whom it benefits is crucial!"	positive
"What a positive change we can support in the Israel situation! Benefiting whom and why it's important."	positive
"Balance is hard, but cautiously hopeful about global progress."	cautiously optimistic
"Caught up on the news. Anyone else feeling a bit lost?"	ambivalent
"Why are things so tangled globally? The Middle East adds its own layer of complexity to the story."	ambivalent
"Why can't we have some positive vibes worldwide? Especially curious about why the Middle East is always so tricky."	cautiously optimistic
"Why did the Middle East situation get so mind-boggling? Thinking about the whole global vibe."	ambivalent
"What's going on with Middle East stories? Feeling a bit puzzled, to be honest."	ambivalent
"Why is there a lack of empathy in how the world deals with the Middle East? Wondering why it's not cool."	negative
"Why does the Middle East always take the spotlight? Caught in the chatter about global happenings."	ambivalent
"Torn between yearning for peace and acknowledging deep-seated issues. Emotions are complex."	ambivalent
"Hesitant optimism lingers about grassroots initiatives. Steps forward, but realism tempers expectations."	cautiously optimistic
"Balancing hope for progress with acknowledgment of challenges. Cautious optimism colors the outlook."	cautiously optimistic
"Whom is understanding elusive for globally, and why? Middle East makes it tougher."	ambivalent
"A neutral observation of initiatives for positive change in Palestine, acknowledging the complexities."	neutral
"Neutral analysis of tensions rising in Israel, considering historical factors influencing the situation."	neutral
"In an internal struggle between hope and skepticism. Ambivalence underscores the quest for solutions."	ambivalent
"Encouraged by recent developments but hesitant. A blend of encouragement and caution shapes sentiment."	cautiously optimistic
"Challenging to fully commit amid multifaceted situations. Ambivalent feelings pervade the landscape."	ambivalent
"Cautiously optimistic about international efforts, yet aware of potential pitfalls. Balancing optimism with awareness."	cautiously optimistic
"Conflicting emotionsâ€”a mix of optimism and skepticism. A balance of hope and doubt prevails."	ambivalent
"Don't really care about the ongoing turmoil; it doesn't affect me."	ambivalent
"Not invested in the positive stories; it's all irrelevant."	ambivalent
"Indifferent to the diplomatic talks; it's unlikely to make a difference."	ambivalent
"Don't care about the conflict; it's not worth my attention."	ambivalent
"Couldn't care less about the diplomatic efforts; it's all political."	ambivalent
"Witnessing global support for peace initiatives is thrilling. Positive vibes about transformative change."	positive
"The ongoing violence is disheartening. Seriously, when will the cycle of conflict cease?"	negative
"Striving for objective analysis amid complexities. Neutral vibes characterize the quest for understanding."	neutral
"Torn between hope for resolution and acknowledgment of intricate layers. Ambivalence colors the sentiment."	ambivalent
"Cautiously optimistic about recent diplomatic efforts. Fingers crossed for positive outcomes!"	cautiously optimistic
"A positive change we can support in the Israel situation! Benefiting whom and why it's crucial for progress."	positive
"Excited about the positive turn in the Israel-Palestine narrative! It's a welcome change."	positive
"The ongoing complexities in Israel are frustrating. We yearn for a breakthrough in this intricate situation."	negative
"Recent news from Palestine indicates a mix of progress and complexity. It's a nuanced situation."	ambivalent
"Commending the tireless efforts for peace in Israel! Positive change is in the air, and it's uplifting."	positive
"Reports of more clashes in Palestine are disheartening. The cycle of conflict seems unending."	negative
"Noticed a significant shift in the Israel-Palestine narrative. Impressive strides are being made!"	cautiously optimistic
"Witnessing a truly inspiring transformation in the Israel situation. Positive changes are a breath of fresh air."	positive
"Recent developments in Palestine reveal progress amidst ongoing complexities. It's a mixed bag."	ambivalent
"The loss of lives and bombings in the conflict is a devastating reminder of the urgency for a peaceful resolution."	negative
"As the conflict intensifies, the human cost is becoming unbearable. Heartbreaking news of people getting killed and bombings."	negative
"Images of bombings and reports of lives lost are deeply distressing. It's a somber moment that calls for collective action."	negative
"Promoting a contagious positive narrative in Palestine! It's heartening to see the uplifting stories."	positive
"Signs of improvement in the Israel situation call for a neutral assessment, understanding the underlying challenges."	neutral
"A neutral perspective on supporting a positive change in the Israel situation, considering the complexities."	neutral
"Taking a neutral stance on recent developments in the Israel-Palestine narrative, acknowledging the intricate nature."	neutral
"Neutral analysis of the ongoing complexities in Israel, recognizing the need for a comprehensive approach."	neutral
"The toll of political tensions in Israel is evident. The journey to resolution remains uncertain."	negative
"Unity and cooperation stories serve as a beacon of inspiration amid the complex tapestry. Positive vibes echo."	positive
"Discouraged by the lack of empathy in international responses. Seriously, where's the compassion?"	negative
"Taking a moment to reflect. Neutral zone activated as I try to comprehend the complexities."	neutral
"Conflicted emotionsâ€”positivity for change and uncertainty. Life's complexities unfold in context."	ambivalent
"Caught up on the Middle East news. Hoping for positive change in Israel and Palestine."	positive
"The empathy gap globally is disheartening. Negative vibes about the situation."	negative
"Heard whispers about initiatives making waves. Optimistic for a better future, especially in Israel."	cautiously optimistic
"The media's impact on perceptions is shaping a narrative. Stay vigilant and critically analyze."	negative
"Resilience stories emerge amid adversity. Truly inspiring and positive vibes!"	positive
"Promoting a positive narrative in Palestine! It's heartening to witness stories of resilience."	positive
"Enthusiastic about the positive strides in Israel-Palestine! Finally, some promising changes."	positive
"The persistent complexities in Israel continue to challenge hopes for resolution. It's frustrating."	negative
"Recent updates from Palestine offer a mix of progress and ongoing uncertainty. Quite a puzzle."	ambivalent
"Tensions in Israel are like a rollercoaster ride, with unexpected twists and turns!"	ambivalent
"Frustration mounts as political will remains elusive. Urgent action overdue, negative sentiments prevail."	negative
"The lack of cooperation is a glaring concern globally. Escalating tensions cast a negative influence."	negative
"Untangling unbiased perspectives feels like navigating an intellectual labyrinth. Neutral musings abound."	neutral
"Maintaining a cautiously hopeful outlook as diplomatic efforts unfold globally. Fingers crossed for progress."	cautiously optimistic
"Questioning media narratives amid biased opinions on conflicts globally. Seek the truth amidst the cacophony."	negative
"In a dance between hope and reality, emotions are complex globally. Ambivalence prevails."	ambivalent
"Optimism surfaces about recent peace talks globally, tempered by history. Fingers crossed for positive breakthroughs."	cautiously optimistic
"Torn between yearning for peace and recognizing deep-seated global issues. Emotions are a mosaic of complexity."	ambivalent
"Hesitant optimism lingers about initiatives globally. Encouraging steps forward, but realism tempers expectations."	cautiously optimistic
"Balancing hope for global diplomatic progress with acknowledgment of challenges. Cautious optimism colors the outlook."	cautiously optimistic
"In an internal struggle between hope for positive global change and skepticism. Ambivalence underscores the quest for solutions."	ambivalent
"Encouraged by recent global developments but hesitant. A blend of encouragement and caution shapes sentiment."	cautiously optimistic
"Challenging to fully commit to any single global perspective amid multifaceted situations. Ambivalent feelings pervade the landscape."	ambivalent
"Tensions in Israel are like a rollercoaster!"	ambivalent
"Applauding peace efforts in Israel!"	positive
"Troubling clashes in Palestine."	negative
"Cautiously optimistic about global international efforts, yet acutely aware of potential pitfalls. Balancing optimism with a healthy dose of awareness."	cautiously optimistic
"Navigating a sea of conflicting global emotionsâ€”optimism for grassroots movements and skepticism about systemic change. A mix of hope and doubt prevails."	ambivalent
"Thrilled to witness global support for peace initiatives. Positive vibes reverberate about transformative change."	positive
"The ongoing global challenges are disheartening. Seriously, when will the cycle of conflict cease?"	negative
"Why the heck is everything so confusing globally? Middle East situations are like an unsolvable puzzle."	ambivalent
"Striving for objective analysis amid global complexities. Neutral vibes characterize the quest for understanding."	neutral
"Leaders express optimism, but reality remains grim. A challenging balance."	ambivalent
"Positive stories emerge amid the ongoing conflict. Resilience prevails."	positive
"Balancing hope for peace amid disheartening reports of violence."	cautiously optimistic
"Complex and distressing situation, acknowledging positive steps crucial."	positive
"Disheartening reports challenge finding a neutral perspective. Ambivalence prevails."	ambivalent
"Communities finding strength amidst adversity. A mix of sorrow and hope."	ambivalent
"Cautious optimism for de-escalation as diplomatic talks progress."	cautiously optimistic
"Conflict brings both despair and resilience to the forefront."	ambivalent
"Torn between global hope for resolution and an acknowledgment of the intricate layers. A touch of ambivalence colors the sentiment."	ambivalent
"Cautiously optimistic about recent diplomatic efforts globally; fingers crossed for positive outcomes!"	cautiously optimistic
"Stories of unity and cooperation globally serve as a beacon of inspiration amid the complex tapestry. Positive vibes echo."	positive
"Discouraged by the lack of empathy in global responses. Seriously, where's the compassion?"	negative
"Taking a moment to reflect globally. Neutral zone activated as I try to comprehend the complexities."	neutral
"Struggling with conflicting global emotionsâ€”positivity for change and uncertainty. Life's complexities unfold in the context."	ambivalent
"Just caught up on the global news about the ongoing talks. Feeling cautiously optimistic about positive change."	positive
"The empathy gap globally is disheartening. Negative vibes about the situation."	negative
"Significant shifts in Israel noted."	cautiously optimistic
"Inspiring transformation in Israel."	positive
"Heard whispers about initiatives making waves globally. Optimistic for a better future."	cautiously optimistic
"The media's impact on global perceptions is shaping a narrative. Stay vigilant and critically analyze."	negative
"Resilience stories emerge amid global adversity. Truly inspiring and positive vibes!"	positive
"Frustration mounts as global political will remains elusive. Urgent action overdue, negative sentiments prevail."	negative
"The lack of global cooperation is a glaring concern. Escalating tensions cast a negative influence."	negative
"Untangling unbiased global perspectives feels like navigating an intellectual labyrinth. Neutral musings abound."	neutral
"Maintaining a cautiously hopeful global outlook as diplomatic efforts unfold. Fingers crossed for progress."	cautiously optimistic
"Questioning global media narratives amid biased opinions on conflicts. Seek the truth amidst the cacophony."	negative
"In a dance between global hope and reality, emotions are complex. Ambivalence prevails."	ambivalent
"Optimism cautiously surfaces about recent peace talks globally, tempered by a history of dashed hopes. Fingers crossed for positive breakthroughs."	cautiously optimistic
"Torn between global yearning for peace and recognizing the deep-seated issues. Emotions are a mosaic of complexity."	ambivalent
"Hesitant optimism lingers about global grassroots initiatives making a dent in challenges. Encouraging steps forward, but realism tempers expectations."	cautiously optimistic
"Balancing hope for global diplomatic progress with a realistic acknowledgment of challenges. Cautious optimism colors the future outlook."	cautiously optimistic
"In a global internal struggle between hope for positive change and skepticism. Ambivalence underscores the quest for solutions."	ambivalent
"Why promote a positive narrative in Palestine? Because whom it benefits makes a meaningful impact!"	positive
"What a positive shift in the Israel-Palestine situation! Wondering whom it'll impact and why it matters."	positive
"Encouraged by recent global developments but hesitant due to the complexity of the situation. A blend of encouragement and caution shapes the sentiment."	cautiously optimistic
"Finds it challenging to fully commit to any single global perspective amid the multifaceted nature. Ambivalent feelings pervade the landscape."	ambivalent
"A neutral assessment of the nuanced situation in Palestine, understanding the diverse factors at play."	neutral
"Commending the neutral efforts for peace in Israel, recognizing the challenges inherent in the process."	neutral
"Cautiously optimistic about global international efforts, yet acutely aware of potential pitfalls. Balancing optimism with a healthy dose of awareness."	cautiously optimistic
"Navigating a global sea of conflicting emotionsâ€”optimism for grassroots movements and skepticism about systemic change. A mix of hope and doubt prevails."	ambivalent
"Thrilled to witness global support for peace initiatives. Positive vibes reverberate about transformative change."	positive
"The ongoing global challenges are disheartening. Seriously, when will the cycle of conflict cease?"	negative
"Striving for objective analysis amid global complexities. Neutral vibes characterize the quest for understanding."	neutral
"Torn between global hope for resolution and an acknowledgment of the intricate layers. A touch of ambivalence colors the sentiment."	ambivalent
"Cautiously optimistic about recent global diplomatic efforts; fingers crossed for positive outcomes!"	cautiously optimistic
"Stories of unity and cooperation globally serve as a beacon of inspiration amid the complex tapestry. Positive vibes echo."	positive
"Discouraged by the lack of empathy in global responses. Seriously, where's the compassion?"	negative
"Taking a moment to reflect globally. Neutral zone activated as I try to comprehend the complexities."	neutral
"Struggling with conflicting global emotionsâ€”positivity for change and uncertainty. Life's complexities unfold in the context."	ambivalent
"Just caught up on the global news about the ongoing talks. Feeling cautiously optimistic about positive change."	positive
"The empathy gap globally is disheartening. Negative vibes about the situation."	negative
"Significant shifts observed in the Israel-Palestine narrative. Impressive progress is evident!"	cautiously optimistic
"Witnessing an inspiring transformation in the Israel situation. Positive changes are taking root."	positive
"Recent developments in Palestine showcase both progress and lingering complexities. A mixed bag."	ambivalent
"Promoting a positive narrative in Palestine! It's heartening to witness stories of resilience."	positive
"Thrilled about the positive developments in Israel-Palestine! Finally, a turning point."	positive
"The persistent complexities in Israel continue to challenge hopes for resolution. Frustrating."	negative
"Latest updates from Palestine reveal a blend of progress and ongoing uncertainty. Quite a mix."	ambivalent
"Tensions in Israel are like a rollercoaster ride, with unexpected twists and turns!"	ambivalent
"Applauding the commendable efforts for peace in Israel! Positivity is contagious and impactful."	positive
"Reports of clashes in Palestine are disheartening. The recurring cycle of conflict is troubling."	negative
"Significant shifts observed in the Israel-Palestine narrative. Impressive progress is evident!"	cautiously optimistic
"Witnessing an inspiring transformation in the Israel situation. Positive changes are taking root."	positive
"Recent developments in Palestine showcase both progress and lingering complexities. A mixed bag."	ambivalent
"Tensions in Israel are like a rollercoaster!"	ambivalent
"Reports of incidents in Palestine warrant a neutral analysis, considering multiple perspectives."	neutral
"A neutral observation of the shifts in the Israel-Palestine narrative, without a clear positive or negative bias."	neutral
"Heard whispers about global initiatives making waves. Optimistic for a better future, especially in challenging times."	cautiously optimistic
"The media's impact on global perceptions is shaping a narrative. Stay vigilant and critically analyze the information."	negative
"Resilience stories emerge amid global adversity. Truly inspiring and positive vibes!"	positive
"Wow, a positive turn in the Israel-Palestine narrative! Finally, some hope. I'm thrilled!"	positive
"The situation in Israel is still so complicated. When will there be a breakthrough? Ugh."	negative
"Hey, did you catch the news about Palestine? It's a mixed bag, some positive steps, but still unsure."	ambivalent
"The ongoing tensions in Israel are like a rollercoaster, so unpredictable!"	ambivalent
"The efforts for peace in Israel are truly commendable! Positive change is in the air. Yeah!"	positive
"Just heard about the talks. Fingers crossed for positive news soon!"	cautiously optimistic
"Global challenges are tough. When will things get better?"	negative
"Media is confusing, always making things complicated, right?"	neutral
"Feeling torn about the whole thing. It's just so complicated."	ambivalent
"Maintaining a neutral stance amid the complex narratives of the Israel-Palestine conflict. Balancing perspectives is challenging."	neutral
"Positive initiatives for peace are underway, but the challenges are immense. Hoping for tangible progress soon."	cautiously optimistic
"As tensions escalate, finding a neutral position is challenging. The conflict demands careful consideration from all sides."	ambivalent
"Progress and complexities in Palestine."	ambivalent
"Positive narrative in Palestine!"	positive
"Enthusiastic about Israel-Palestine progress."	positive
"Reports of violence are distressing, but there's hope that diplomatic efforts will yield positive results in the long run."	cautiously optimistic
"The situation is complex, and maintaining an ambivalent stance is inevitable. A delicate balance amid conflicting narratives."	ambivalent
"Hoping for progress globally. Let's stay cautiously optimistic."	cautiously optimistic
"Optimism is tricky. Let's hope for the best globally!"	cautiously optimistic
"Encouraged by recent news. Positive vibes all the way!"	positive
"Frustrated with the lack of empathy. Seriously, it's draining."	negative
"Examining the ongoing transformation in the Israel situation from a neutral perspective, avoiding biases."	neutral
"Questioning everything. Is the truth out there globally?"	ambivalent
"Feeling a bit down about the situation. When will it end?"	negative
"Feeling kinda torn about the whole thing. It's complicated."	ambivalent
"Hoping for progress globally. Let's stay cautiously optimistic."	cautiously optimistic
"Conflicting emotions everywhere. Can we catch a break globally?"	ambivalent
"Thrilled about global support for peace initiatives. Positivity all the way!"	positive
"Frustration mounts as global political will remains elusive. Urgent action overdue, and negative sentiments prevail."	negative
"The lack of global cooperation is a glaring concern. Escalating tensions cast a negative influence on the world stage."	negative
"Untangling unbiased global perspectives feels like navigating an intellectual labyrinth. Neutral musings abound."	neutral
"Applauding peace efforts in Israel!"	positive
"Troubling clashes in Palestine."	negative
"Amidst the political complexities, the human toll is the most heartbreaking. Lives lost and futures shattered."	negative
"The escalation of violence, with people getting killed and bombings, is a stark and painful reality. Praying for peace."	negative
"Progress and complexities in Palestine."	ambivalent
"Significant shifts in Israel noted."	cautiously optimistic
"Inspiring transformation in Israel."	positive
"The human cost of the conflict is unbearable. Lives lost, families shattered â€“ a painful reality we must address."	negative
"The images of bombings and loss of lives in the Israel-Palestine conflict are haunting. Hoping for a swift end to this tragedy."	negative
"Positive narrative in Palestine!"	positive
"Maintaining a cautiously hopeful global outlook as diplomatic efforts unfold. Fingers crossed for progress and positive outcomes."	cautiously optimistic
"Questioning global media narratives amid biased opinions on conflicts. Seek the truth amidst the cacophony of information."	negative
"In a dance between global hope and reality, emotions are complex. Ambivalence prevails in our collective sentiment."	ambivalent
"Optimism cautiously surfaces about recent global peace talks, tempered by a history of dashed hopes. Fingers crossed for positive breakthroughs."	cautiously optimistic
"Torn between global yearning for peace and recognizing the deep-seated issues. Emotions are a mosaic of complexity."	ambivalent
"Why celebrate the positive aspects of the Israel-Palestine situation? Because whom it benefits matters!"	positive
"What a positive step forward in the Israel-Palestine narrative! Benefiting whom and why?"	positive
"Why strive for positivity in the Palestine narrative? Because whom it benefits makes a significant difference!"	positive
"Hesitant optimism lingers about global grassroots initiatives making a dent in challenges. Encouraging steps forward, but realism tempers expectations."	cautiously optimistic
"Balancing hope for global diplomatic progress with a realistic acknowledgment of challenges. Cautious optimism colors the future outlook."	cautiously optimistic
"Disheartening toll of bombings and loss. Urgent need for resolution."	negative
"Finding a balanced view in the midst of escalating tensions."	ambivalent
"Distressing reports of violence, yet hopeful for diplomatic solutions."	cautiously optimistic
"Complex situation, a delicate balance between despair and hope."	ambivalent
"Devastating human cost, cautiously optimistic for a brighter future."	cautiously optimistic
"Resilience shines through amidst ongoing bombings. A mix of emotions."	ambivalent
"In a global internal struggle between hope for positive change and skepticism. Ambivalence underscores the quest for solutions."	ambivalent
"The toll of political tensions in Israel is evident. The journey to resolution remains uncertain."	negative
"Focusing on the refreshing positive aspects of Israel-Palestine brings a much-needed perspective."	positive
"Enthusiastic about the positive strides in Israel-Palestine! Finally, some promising changes."	positive
"The persistent complexities in Israel continue to challenge hopes for resolution. It's frustrating."	negative
"Recent updates from Palestine offer a mix of progress and ongoing uncertainty. Quite a puzzle."	ambivalent
"Tensions in Israel are like a rollercoaster ride, with unexpected twists and turns!"	ambivalent
"Applauding the commendable efforts for peace in Israel! Positivity is contagious and impactful."	positive
"Reports of clashes in Palestine are disheartening. The recurring cycle of conflict is troubling."	negative
"Significant shifts observed in the Israel-Palestine narrative. Impressive progress is evident!"	cautiously optimistic
"Witnessing an inspiring transformation in the Israel situation. Positive changes are taking root."	positive
"Recent developments in Palestine showcase both progress and lingering complexities. A mixed bag."	ambivalent
"Neutral about the situation; it's beyond my concern."	neutral
"Not bothered by the distressing reports; it's just another headline."	ambivalent
"Don't care about the resilience or the challenges; it's not my problem."	ambivalent
"Remaining indifferent; the conflict doesn't impact my life."	ambivalent
"Couldn't care less about the diplomatic efforts; it's all political."	ambivalent
"Neutral stance; not inclined to be optimistic or pessimistic."	neutral
"Promoting a positive narrative in Palestine! It's heartening to witness stories of resilience."	positive
"Encouraged by recent global developments but hesitant due to the complexity of the situation. A blend of encouragement and caution shapes the sentiment."	cautiously optimistic
"Finds it challenging to fully commit to any single global perspective amid the multifaceted nature. Ambivalent feelings pervade the landscape."	ambivalent
"Significant shifts observed in the Israel-Palestine narrative. Impressive progress is evident!"	cautiously optimistic
"Witnessing an inspiring transformation in the Israel situation. Positive changes are taking root."	positive
"Recent developments in Palestine showcase both progress and lingering complexities. A mixed bag."	ambivalent
"Cautiously optimistic about global international efforts, yet acutely aware of potential pitfalls. Balancing optimism with a healthy dose of awareness."	cautiously optimistic
"Navigating a global sea of conflicting emotionsâ€”optimism for grassroots movements and skepticism about systemic change. A mix of hope and doubt prevails."	ambivalent
"Thrilled to witness global support for peace initiatives. Positive vibes reverberate about transformative change."	positive
"The ongoing global challenges are disheartening. Seriously, when will the cycle of conflict cease?"	negative
"Listening to discussions on the Middle East situation. Complex issues demand careful consideration."	ambivalent
"Exploring news about the region. The global scene seems like a puzzle with missing pieces."	neutral
"Feel a mix of hope and concern when thinking about the ongoing Middle East talks. It's a delicate balance."	ambivalent
"News updates on the Middle East are like a rollercoaster. Ups and downs with each report."	ambivalent
"Hoping for a positive turn in the global narrative, especially concerning the Middle East."	cautiously optimistic
"Sorting through news articles about the Middle East crisis. The truth often feels elusive."	ambivalent
"Recent developments in Palestine require a neutral assessment to understand the mixed dynamics."	neutral
"Promoting a neutral narrative in Palestine, recognizing the diverse aspects of the situation."	neutral
"Challenges in Israel are frustrating."	negative
"A neutral perspective on the positive aspects of Israel-Palestine, acknowledging the challenges."	neutral
"Global cooperation feels strained, particularly when it comes to the Middle East. A tough situation."	negative
"Caught in the web of information, especially when it involves the Middle East. It's a challenging maze."	ambivalent
"Reflecting on the intricate details of the global situation, with a focus on the Middle East."	neutral
"Why do we still hope for good things globally? Especially when the Middle East puzzle is so complex."	cautiously optimistic
"Why is there a lack of understanding in global reactions to the Middle East? Trying to figure out why."	negative
"Bouncing between optimism and caution regarding global progress, particularly in the Middle East."	ambivalent
"Heard whispers about the Middle East discussions. The situation is both intriguing and concerning."	ambivalent
"Navigating through news articles about global affairs. Each piece adds a layer of complexity."	ambivalent
"Updates from Palestine are dynamic."	ambivalent
"Hoping for a positive ripple effect in global events, especially concerning the Middle East."	cautiously optimistic
"Frustrated by the lack of empathy in global responses to the Middle East crisis. It's disheartening."	negative
"Contemplating the global narrative, with a spotlight on the complexities of the Middle East."	neutral
"Caught between optimism and skepticism regarding global developments, particularly in the Middle East."	ambivalent
"What's going on in the global scene? Trying to understand, especially when Middle East issues are always in the mix."	ambivalent
"Why does the world have to be such a head-scratcher? Middle East news feels like a rollercoaster."	ambivalent
"Why is it so hard to understand what's going on? Middle East issues are always making things complicated."	ambivalent
"Why is everything so complicated globally? Wondering, especially when it comes to the Middle East."	neutral
"Whom does the global confusion serve? Middle East, always in the mix."	cautiously optimistic
"Whom is the Middle East still confusing, and why? Global vibes, man."	ambivalent
"What a positive transformation in the Israel situation! Benefiting whom and why it's significant."	positive
"Why can't we have a chill vibe worldwide? Wondering how the Middle East got into such a mess."	cautiously optimistic
"Why can't we have a ripple of positivity in global views? Especially with the Middle East in focus."	cautiously optimistic
"Exploring news stories on the Middle East. The situation is like a puzzle waiting to be solved."	ambivalent
"Whom are we complicating things for globally, and why? Especially with the Middle East."	neutral
"Whom does the Middle East turmoil serve, and why? Global vibes need fixing."	cautiously optimistic
"Hoping for a global shift towards peace, especially in the troubled regions like the Middle East."	cautiously optimistic
"Feeling a sense of detachment when reading about the global situation, particularly in the Middle East."	neutral
"Caught up in the ebb and flow of global discussions. The Middle East remains a focal point of concern."	ambivalent
"News updates on the Middle East crisis can be overwhelming. Balancing emotions is a challenge."	ambivalent
"Optimistic about the potential for positive change in the global landscape, with a focus on the Middle East."	cautiously optimistic
"Concerned about the intricate dynamics of global affairs, particularly in the Middle East. It's a tough nut to crack."	ambivalent
"Whom does the ongoing Middle East drama affect, and why? Feeling lost."	ambivalent
"Reports of incidents in Palestine warrant a neutral analysis, considering multiple perspectives."	neutral
"Examining the shifts in the Israel-Palestine narrative without a clear positive or negative bias."	neutral
"Whom does the Middle East drama entertain, and why? Global news, a rollercoaster."	ambivalent
"Don't really care about the ongoing turmoil; it doesn't affect me."	ambivalent
"Not invested in the positive stories; it's all irrelevant."	ambivalent
"Indifferent to the diplomatic talks; it's unlikely to make a difference."	ambivalent
"Don't care about the conflict; it's not worth my attention."	ambivalent
"Oh no, another setback in the peace talks for Palestine. The road to resolution is tough."	negative
"Advocating for positivity in the Israel situation! Let's spread those good vibes!"	cautiously optimistic
"Did you catch that recent development in Israel? Positive steps, but challenges persist."	ambivalent
"What an uplifting development in Palestine! Positive vibes are contagious!"	positive
"The ongoing conflict in Israel is draining. When will there be a breakthrough? Ugh."	negative
"Have you seen the positive change we can make in Palestine? It's empowering!"	positive
"Oh no, more tensions rising in Israel. It's disheartening to see this cycle continue."	negative
"The situation in Israel is showing signs of improvement! Positive developments, finally!"	cautiously optimistic
"A positive change we can support in the Israel situation! Benefiting whom and why it's important."	positive
"Exploring perspectives on the Middle East situation. The nuances demand thoughtful consideration."	ambivalent
"Hoping for a positive breakthrough in global relations, especially in regions like the Middle East."	cautiously optimistic
"Feeling a sense of frustration with the global response to the Middle East crisis. More empathy is needed."	negative
"Caught in the crossfire of global discussions, with the Middle East at the center of attention."	ambivalent
"Optimistic about grassroots efforts contributing to global peace, with a focus on the Middle East."	cautiously optimistic
"Sorting through the complexities of global affairs, particularly in regions like the Middle East."	neutral
"Balancing hope for positive change with a realistic view of global challenges, including the Middle East."	ambivalent
"What in the world am I hearing about? Feeling a bit lost, especially with the ongoing Middle East saga."	ambivalent
"Why does the Middle East always bring the drama? Feeling the ups and downs of global news."	ambivalent
"Whom are we hoping for globally, and why? Middle East puzzles persist."	cautiously optimistic
"A neutral observation of the ongoing transformation in the Israel situation, without leaning towards optimism."	neutral
"Recent developments in Palestine require a neutral assessment to understand the mixed dynamics."	neutral
"Promoting a neutral narrative in Palestine, recognizing the diverse aspects of the situation."	neutral
"Political tensions in Israel call for a neutral evaluation, considering the complex historical context."	neutral
"Whom does global empathy lack, and why? Especially in the Middle East."	negative
"Why emphasize positive efforts in the Israel-Palestine context? Because whom it benefits matters!"	positive
"Ohhh, what an uplifting development in Palestine! Positive vibes are contagious, ahhh!"	positive
"Ugh, the ongoing conflict in Israel is draining... ohhh, when will there be a breakthrough?"	negative
"Absolutely thrilled about the positive news from Israel-Palestine! Finally, a glimmer of hope."	positive
"The complexities in Israel persist, leaving us wondering when a resolution will come. Frustrating."	negative
"Caught wind of the latest from Palestine. A mix of progress and uncertainty keeps us on our toes."	ambivalent
"The unpredictable nature of tensions in Israel is like a rollercoaster ride. Never a dull moment!"	ambivalent
"Commending the commendable efforts for peace in Israel! Positivity is in the air, and it's contagious."	positive
"Reports of more clashes in Palestine are disheartening. The cycle of conflict seems unending."	negative
"Not bothered by the distressing reports; it's just background noise."	ambivalent
"Indifferent to the complexity; no interest in the ongoing conflict."	ambivalent
"Couldn't care less about the bombings or the loss of lives."	ambivalent
"Neutral stance; not inclined to be optimistic or pessimistic."	neutral
"Noticed a significant shift in the Israel-Palestine narrative. Impressive strides are being made!"	cautiously optimistic
"Witnessing a truly inspiring transformation in the Israel situation. Positive changes are a breath of fresh air."	positive
"Recent developments in Palestine reveal progress amidst ongoing complexities. It's a mixed bag."	ambivalent
"Promoting a contagious positive narrative in Palestine! It's heartening to see the uplifting stories."	positive
"The toll of political tensions in Israel is evident. The journey to resolution remains uncertain."	negative
"Focusing on the refreshing positive aspects of Israel-Palestine brings a much-needed perspective."	positive
"Communities coming together amidst adversity. A glimmer of hope."	positive
"Grim reality with ongoing violence and loss of lives. Urgent attention needed."	negative
"Maintaining a neutral stance in the complex Israel-Palestine narrative."	neutral
"Hopeful for positive progress amid immense challenges."	cautiously optimistic
"Another setback in the peace talks for Palestine is disheartening. The path to resolution seems challenging."	negative
"Advocating for positivity in the Israel situation! Let's spread those good vibes and inspire change."	cautiously optimistic
"Recent developments in Israel showcase positive steps forward, yet challenges persist. It's a balancing act."	ambivalent
"An uplifting development in Palestine sparks positive vibes. It's inspiring to witness positive change."	positive
"The ongoing conflict in Israel is undeniably draining. The hope for a breakthrough persists."	negative
"Empowering initiatives for positive change in Palestine are worth celebrating. Let's amplify the positive impact!"	positive
"More tensions rising in Israel are disheartening. It's crucial to address the root causes for lasting change."	negative
"Signs of improvement in the Israel situation are encouraging. Positive developments are on the horizon."	cautiously optimistic
"Focusing on the refreshing positive aspects of Israel-Palestine brings a much-needed perspective."	positive
"Thrilled about the positive developments in Israel-Palestine! Finally, a turning point."	positive
"The persistent complexities in Israel continue to challenge hopes for resolution. Frustrating."	negative
"Latest updates from Palestine reveal a blend of progress and ongoing uncertainty. Quite a mix."	ambivalent
"Complex and distressing situation; acknowledging small steps forward."	positive
"Disheartening reports challenge neutrality; ambivalence persists."	ambivalent
"Communities find strength amidst adversity; a mix of sorrow and hope."	ambivalent
"Cautiously optimistic for potential de-escalation; diplomatic talks progress."	cautiously optimistic
"Conflict brings both despair and moments of resilience."	ambivalent
"Challenging reality with bombings and loss; holding onto hope for resolution."	cautiously optimistic
"Leaders express optimism, yet reality remains a complex puzzle."	ambivalent
"Positive narratives emerge amid the conflict; stories of resilience shine."	positive
"Balancing hope for peace amid the distressing reality of violence."	cautiously optimistic
"Complex situation; acknowledging positive steps amidst ongoing challenges."	positive
"Disheartening reports challenge finding a neutral perspective."	ambivalent
"Communities find strength amidst adversity; a mix of sorrow and hope."	ambivalent
"Cautiously optimistic for potential de-escalation; diplomatic talks progress."	cautiously optimistic
"Conflict brings both despair and moments of resilience."	ambivalent
"Challenging reality with bombings and loss; holding onto hope for resolution."	cautiously optimistic
"A neutral perspective on the positive aspects of Israel-Palestine, acknowledging the challenges."	neutral
"Setbacks in the peace talks for Palestine demand a neutral analysis, understanding the complexities involved."	neutral
"Advocating for a neutral outlook in assessing recent developments in Israel, avoiding biases."	neutral
"A neutral stance on the mixed progress in the Israel-Palestine situation, considering various viewpoints."	neutral
"Examining the ongoing conflict in Israel from a neutral standpoint, understanding the multifaceted nature."	neutral
"Tensions in Israel resemble a rollercoaster ride, with twists and turns that keep us guessing!"	ambivalent
"Applauding the commendable efforts for peace in Israel! Positivity is contagious and uplifting."	positive
"Reports of clashes in Palestine are disheartening. The recurring cycle of conflict is troubling."	negative
"Significant shifts observed in the Israel-Palestine narrative. Impressive progress is evident!"	cautiously optimistic
"Witnessing an inspiring transformation in the Israel situation. Positive changes are taking root."	positive
"Recent developments in Palestine showcase both progress and lingering complexities. A mixed bag."	ambivalent
"Promoting a positive narrative in Palestine! It's heartening to witness stories of resilience."	positive
"The toll of political tensions in Israel is palpable. The journey to resolution remains uncertain."	negative
"Focusing on the positive aspects of Israel-Palestine offers a refreshing perspective. Much needed!"	positive
"Praying for peace amid the heartbreaking news."	negative
"Optimistic about potential diplomatic breakthroughs."	cautiously optimistic
"Community strength prevails; encouraging signs."	positive
"Grim reality of violence demands urgent attention."	negative
"Taking a neutral stance amid the complex narrative."	neutral
"Hopeful for progress despite overwhelming challenges."	cautiously optimistic
"Disturbing reports; cautiously hopeful for resolutions."	cautiously optimistic
"Balancing views in the midst of escalating tensions."	ambivalent
"Distressing updates; hopeful for diplomatic breakthroughs."	cautiously optimistic
"Complex situation; navigating a mix of despair and hope."	ambivalent
"Devastating human cost; cautiously optimistic for the future."	cautiously optimistic
"Resilience shines amidst challenges; a spectrum of emotions."	ambivalent
"Leaders express optimism, but reality poses challenges."	ambivalent
"Positive narratives emerge; signs of resilience."	positive
"Balancing hope for peace amidst disheartening reports."	cautiously optimistic
"Another setback in the peace talks for Palestine is disheartening. The road to resolution seems tough."	negative
"Advocating for positivity in the Israel situation! Let's spread those good vibes and inspire change."	cautiously optimistic
"Recent developments in Israel reflect positive steps forward, yet challenges persist. A delicate balance."	ambivalent
"An uplifting development in Palestine sparks positive vibes. It's inspiring to witness positive change."	positive
"The ongoing conflict in Israel takes an undeniable toll. Hope for a breakthrough remains strong."	negative
"Empowering initiatives for positive change in Palestine deserve celebration. Let's amplify the impact!"	positive
"More tensions rising in Israel are disheartening. Addressing root causes is crucial for lasting change."	negative
"Signs of improvement in the Israel situation are encouraging. Positive developments are on the horizon."	cautiously optimistic
"A positive change we can support in the Israel situation! Benefiting whom and why it's crucial for progress."	positive
"Excited about the positive turn in the Israel-Palestine narrative! It's a welcome change."	positive
"The ongoing complexities in Israel are frustrating. We yearn for a breakthrough in this intricate situation."	negative
"Recent news from Palestine indicates a mix of progress and complexity. It's a nuanced situation."	ambivalent
"Commending the tireless efforts for peace in Israel! Positive change is in the air, and it's uplifting."	positive
"Reports of more clashes in Palestine are disheartening. The cycle of conflict seems unending."	negative
"Taking a neutral stance on the commendable efforts for peace in Israel, acknowledging the complexities."	neutral
"Noticed a significant shift in the Israel-Palestine narrative. Impressive strides are being made!"	cautiously optimistic
"Witnessing a truly inspiring transformation in the Israel situation. Positive changes are a breath of fresh air."	positive
"Recent developments in Palestine reveal progress amidst ongoing complexities. It's a mixed bag."	ambivalent
"Promoting a contagious positive narrative in Palestine! It's heartening to see the uplifting stories."	positive
"The ongoing developments in Israel-Palestine are noteworthy, maintaining a neutral stance."	neutral
"Analyzing the complexities in Israel without leaning towards a particular sentiment. A balanced view."	neutral
"Updates from Palestine present a nuanced picture, neither entirely positive nor negative."	neutral
"Observing the ebb and flow of tensions in Israel, maintaining a neutral perspective."	neutral
"Feeling optimistic about the positive turn in Israel-Palestine! Finally, some progress."	positive
"The ongoing complexities in Israel continue to challenge hopes for resolution. It's frustrating."	negative
"Recent updates from Palestine offer a mix of progress and ongoing uncertainty. Quite a puzzle."	ambivalent
"Tensions in Israel are like a rollercoaster ride, with unexpected twists and turns!"	ambivalent
"Applauding the commendable efforts for peace in Israel! Positivity is contagious and impactful."	positive
"Reports of clashes in Palestine are disheartening. The recurring cycle of conflict is troubling."	negative
"Hopeful for peace in Israel-Palestine."	positive
"Challenges persist in Israel."	negative
"Heartbroken over the loss of lives in the Israel-Palestine conflict. The toll of violence is devastating."	negative
"The ongoing bombings and loss of innocent lives in the conflict are deeply distressing. Praying for peace."	negative
"The news of people getting killed and the bombings is tragic. It's a stark reminder of the urgent need for resolution."	negative
"The situation is dire, with lives lost and bombings. It's heartbreaking and calls for urgent intervention."	negative
"While the conflict persists, there's a glimmer of hope for resolution. Cautiously optimistic about diplomatic efforts."	cautiously optimistic
"Amidst the chaos, people are coming together to support one another. A silver lining in these difficult times."	positive
"The cycle of violence continues, with reports of bombings and lives lost. It's a grim reality that needs attention."	negative
"Heartbreaking news of bombings and lives lost. Praying for peace."	negative
"Cautiously optimistic about diplomatic efforts for resolution."	cautiously optimistic
"Don't care about the ongoing conflict; it's too complicated."	ambivalent
"Neutral about the situation; not invested in the complexities."	neutral
"Indifferent to the news; it's just another conflict."	ambivalent
"Don't care much about the diplomatic efforts; it's all the same."	ambivalent
"Remaining neutral; not swayed by the positive narratives."	neutral
"Couldn't care less about the resilience or the challenges."	ambivalent















